C 100,     180, 255

NO ./assets/xpm/flower.xpm

SO ./assets/xpm/flower2.xpm

WE ./assets/xpm/tree.xpm

EA ./assets/xpm/yoshi.xpm

F  180,       140,        80

           11
           101    111
1111111111100111111111111111111111
11101111111100000000000000011111
100000000000000011100010000111
110000100000N0000000000000111111
  100001111111000000000000111111
1111111000000000000000000001
11110000000000110000000000001
1111111111111111111111111111111111
1
1111111111111111111111111111111111
1100000000000110111100000000011
1000000000001111000001000000001
110000000000111010011000011111 1111111
11000000000111100000010000011
111111111111111111111111111111111