C 0,20 ,255
NO      ./textures/eagle.xpm
SO ./textures/greystone.xpm
EA ./textures/red.xpm
WE ./textures/purplestone.xpm

F  10, 100, 10

           111
           101    111
1111111111101111111111111111111111
1110111111110000000000000001111101
1000000000000001100111000100000N1
110000111111100000000000111111011
1100000000011110000001000001111111
111111111111111111111111111111111