C 255,20 ,30
NO      ./textures/eagle.xpm
SO ./textures/greystone.xpm
EA ./textures/red.xpm
WE ./textures/purplestone.xpm

F  000, 000, 00

           111
           101    111
1111111111101111111111111111111111
11101111111100000000000000011111
100000000000000000111000100001
110000100000000000000000001111     
  100001111111000000000000111111
1111111000000000W00000000000001
111100000000001100000000000011
110000000000011 110000000000011
10000000000011110000000000001
110000000000111000000000001111     
11000000000111100000000000011
111111111111111111111111111111111